NO textures/simonkraft/cobblestone_01.xpm
SO textures/simonkraft/cobblestone_02.xpm
WE textures/simonkraft/bookshelf.xpm
EA textures/simonkraft/basalt_top.xpm

F 18,53,25
C 153,204,255

111111111111111111111111111111
100000000000000000000000000001
100000000000000000000000000001
11000001110101011111011110N011
100000000000000000000000000001
100000000000000000000000000001
100000000000000000000000000001
100000000000000000000000000001
100000000000000000000000000001
111111111111111111111111111111
111             1111
111             1101
111             1111