NO ./assets/north_texture.xpm
SO ./assets/south_texture.xpm
WE ./assets/west_texture.xpm
EA ./assets/east_texture.xpm

F 220,100,0
C 225,30,0

111111
100101
10101111
110001
111111